12
12
############
#...#......#
s.#.#.####.#
###.#....#.#
#....###.#.e
####.#.#.#.#
#..#.#.#.#.#
##.#.#.#.#.#
#........#.#
######.###.#
#......#...#
############